channels 2
notelength 1/8
bpm 163

ㅡㅡㅡㅡㅡㅡㅡㅡ|ㅡㅡㅡㅡㅡㅡㅡㅡ|ㅡㅡㅡㅡㅡㅡㅡㅡ|ㅡㅡㅡㅡㅡㅡㅡㅡ|
ㅡㅡㅡㅡㅡㅡㅡㅡ|ㅡㅡㅡㅡㅡㅡㅡㅡ|ㅡㅡㅡㅡㅡㅡㅡㅡ|ㅡㅡㅡㅡㅡㅡㅡㅡ|

ㅡㅡㅡㅡㅡㅡㅡㅡ|ㅡㅡㅡㅡㅡㅡㅡㅡ|ㅡㅡㅡㅡㅡㅡㅡㅡ|ㅡㅡㅡㅡㅡㅡㅡㅡ|
ㅡㅡㅡㅡㅡㅡㅡㅡ|ㅡㅡㅡㅡㅡㅡㅡㅡ|ㅡㅡㅡㅡㅡㅡㅡㅡ|ㅡㅡㅡㅡㅡㅡㅡㅡ|

아ㅡㅡㅡㅡㅡㅡㅡ|ㅡㅡㅡㅡㅡㅡㅡㅡ|ㅡㅡㅡㅡㅡㅡㅡㅡ|ㅡㅡㅡㅡㅡㅡㅡㅡ|
ㅡㅡㅡㅡㅡㅡㅡㅡ|ㅡㅡㅡㅡㅡㅡㅡㅡ|ㅡㅡㅡㅡㅡㅡㅡㅡ|ㅡㅡㅡㅡㅡㅡㅡㅡ|

안ㅡㅡㅡㅡㅡㅡㅡ|티ㅡㅡㅡㅡㅡㅡㅡ|백ㅡㅡㅡㅡㅡㅡㅡ|서ㅡㅡㅡㅡㅡㅡㅡ|
ㅡㅡㅡㅡㅡㅡㅡㅡ|ㅡㅡㅡㅡㅡㅡㅡㅡ|ㅡㅡㅡㅡㅡㅡㅡㅡ|ㅡㅡㅡㅡㅡㅡㅡㅡ|

ㅡㅡㅡㅡㅡㅡㅡㅡ|ㅡㅡㅡㅡㅡㅡㅡㅡ|ㅡㅡㅡㅡㅡㅡㅡㅡ|ㅡㅡㅡㅡㅡㅡㅡㅡ|
ㅡㅡㅡㅡㅡㅡㅡㅡ|ㅡㅡㅡㅡㅡㅡㅡㅡ|ㅡㅡㅡㅡㅡㅡㅡㅡ|ㅡㅡㅡㅡㅡㅡㅡㅡ|

ㅡㅡㅡㅡㅡㅡㅡㅡ|ㅡㅡㅡㅡㅡㅡㅡㅡ|ㅡㅡㅡㅡㅡㅡㅡㅡ|ㅡㅡㅡㅡㅡㅡㅡㅡ|
ㅡㅡㅡㅡㅡㅡㅡㅡ|ㅡㅡㅡㅡㅡㅡㅡㅡ|ㅡㅡㅡㅡㅡㅡㅡㅡ|ㅡㅡㅡㅡㅡㅡㅡㅡ|

ㅡ(오늘)도일어나ㅡ내|노트북앞에앉아ㅡ|망ㅡㅡ겜ㅡㅡ을ㅡ|켜ㅡㅡ는ㅡㅡ데ㅡ|
ㅡ(ㅡㅡ)ㅡㅡㅡㅡㅡㅡ|ㅡㅡㅡㅡㅡㅡㅡ좆|ㅡㅡㅡㅡㅡㅡㅡㅡ|ㅡㅡㅡㅡㅡㅡㅡㅡ|

ㅡㅡㅡ인생을ㅡ증|명하는나의세이브|데ㅡㅡ이ㅡㅡ터ㅡ|가ㅡㅡ없ㅡㅡ어ㅡ|
ㅡ겜창ㅡㅡㅡㅡㅡ|ㅡㅡㅡㅡㅡㅡㅡㅡ|ㅡㅡㅡㅡㅡㅡㅡㅡ|ㅡㅡㅡㅡㅡㅡㅡㅡ|

ㅡ(아니)이게대체ㅡ무|슨ㅡ같은일인지몇|시ㅡㅡ간ㅡㅡ을ㅡ|헤ㅡㅡ멨ㅡㅡ지ㅡ|
ㅡ(ㅡㅡ)ㅡㅡㅡㅡㅡㅡ|ㅡ좆ㅡㅡㅡㅡㅡㅡ|ㅡㅡㅡㅡㅡㅡㅡㅡ|ㅡㅡㅡㅡㅡㅡㅡㅡ|

ㅡ(그리)고난봤지ㅡ백|신이나의데이터를|ㅡㅡㅡㅡㅡㅡ다ㅡ|는ㅡㅡ알ㅡㅡ림ㅡ|
ㅡ(ㅡㅡ)ㅡㅡㅡㅡㅡㅡ|ㅡㅡㅡㅡㅡㅡㅡㅡ|조ㅡㅡ졌ㅡㅡㅡㅡ|ㅡㅡㅡㅡㅡㅡㅡㅡ|

을ㅡㅡㅡㅡㅡㅡㅡ|ㅡㅡㅡㅡㅡㅡㅡㅡ|ㅡㅡㅡㅡㅡㅡㅡㅡ|ㅡㅡㅡㅡㅡㅡㅡㅡ|
ㅡㅡㅡㅡㅡㅡㅡㅡ|ㅡㅡㅡㅡㅡㅡ개시|발ㅡㅡㅡㅡㅡㅡㅡ|ㅡㅡㅡㅡㅡㅡㅡㅡ|

ㅡㅡㅡㅡㅡㅡㅡㅡ|ㅡㅡㅡㅡㅡㅡㅡㅡ|ㅡㅡㅡㅡㅡㅡㅡㅡ|ㅡㅡㅡㅡㅡㅡㅡㅡ|
ㅡㅡㅡㅡㅡㅡㅡㅡ|ㅡㅡㅡㅡㅡㅡㅡㅡ|ㅡㅡㅡㅡㅡㅡㅡㅡ|ㅡㅡㅡㅡㅡㅡㅡㅡ|

ㅡ(ㅡㅡ)같은백신ㅡ(CP)|U만오지게먹더니|드ㅡㅡ디ㅡㅡ어ㅡ|ㅡㅡㅡㅡㅡㅡ군ㅡ|
ㅡ(개좆)ㅡㅡㅡㅡㅡ(--)|-ㅡㅡㅡㅡㅡㅡㅡ|ㅡㅡㅡㅡㅡㅡㅡㅡ|미ㅡㅡ쳤ㅡㅡㅡㅡ|

ㅡ하지만지금ㅡㅡ|ㅡㅡㅡ의백신을지|워ㅡㅡ버ㅡㅡ린ㅡ|다ㅡㅡ해ㅡㅡ도ㅡ|
ㅡㅡㅡㅡㅡㅡㅡ개|시발놈ㅡㅡㅡㅡㅡ|ㅡㅡㅡㅡㅡㅡㅡㅡ|ㅡㅡㅡㅡㅡㅡㅡㅡ|

ㅡ(이미)ㅡㅡ버린ㅡ내|세이브데이터가살|아ㅡㅡ나ㅡㅡ지ㅡ|는ㅡㅡ못ㅡㅡ해ㅡ|
ㅡ(ㅡㅡ)조져ㅡㅡㅡㅡ|ㅡㅡㅡㅡㅡㅡㅡㅡ|ㅡㅡㅡㅡㅡㅡㅡㅡ|ㅡㅡㅡㅡㅡㅡㅡㅡ|

ㅡ나는ㅡㅡㅡㅡ이|ㅡㅡ같은백신자첼|깔ㅡㅡ지ㅡㅡ말ㅡ|아ㅡㅡ야ㅡㅡ했ㅡ|
ㅡㅡㅡ개시발ㅡㅡ|개좆ㅡㅡㅡㅡㅡㅡ|ㅡㅡㅡㅡㅡㅡㅡㅡ|ㅡㅡㅡㅡㅡㅡㅡㅡ|

어ㅡㅡㅡㅡㅡㅡㅡ|ㅡㅡㅡㅡㅡㅡㅡㅡ|ㅡㅡㅡㅡㅡㅡㅡㅡ|ㅡㅡㅡㅡㅡㅡㅡㅡ|
ㅡㅡㅡㅡㅡㅡㅡㅡ|ㅡㅡㅡㅡㅡㅡ개시|발ㅡㅡㅡㅡㅡㅡㅡ|ㅡㅡㅡㅡㅡ개조졌|

ㅡㅡㅡㅡㅡㅡㅡㅡ|ㅡㅡㅡㅡㅡㅡㅡㅡ|ㅡㅡㅡㅡㅡㅡㅡㅡ|ㅡㅡㅡㅡㅡㅡㅡㅡ|
다ㅡㅡㅡㅡㅡㅡㅡ|ㅡㅡㅡㅡㅡㅡㅡ시|바ㅡㅡㅡㅡㅡㅡㅡ|알ㅡㅡㅡㅡㅡㅡㅡ|
