channels 2
notelength 1/8
bpm 180

ㅡㅡㅡㅡㅡㅡㅡㅡ|ㅡㅡㅡㅡㅡㅡㅡㅡㅡ야ㅡㅡㅡㅡㅡㅡ|어ㅡㅡ딜ㅡㅡ가ㅡㅡ니ㅡㅡㅡㅡㅡㅡ|ㅡㅡㅡㅡㅡㅡㅡㅡㅡ야ㅡㅡㅡㅡㅡㅡ|ㅡㅡㅡㅡㅡㅡㅡㅡㅡㅡㅡㅡㅡㅡㅡㅡ|
ㅡㅡㅡㅡㅡㅡㅡ망|ㅡㅡㅡ나ㅡㅡ니ㅡㅡㅡㅡㅡㅡㅡㅡㅡ|ㅡㅡㅡㅡㅡㅡㅡㅡㅡㅡㅡㅡㅡㅡㅡㅡ|망ㅡㅡ나ㅡㅡ니ㅡㅡㅡㅡㅡㅡㅡㅡㅡ|ㅡㅡㅡㅡㅡㅡㅡㅡㅡㅡㅡㅡㅡㅡㅡㅡ|

ㅡㅡㅡㅡㅡㅡㅡㅡㅡ야ㅡㅡㅡㅡㅡㅡ|어ㅡㅡ딜ㅡㅡ가ㅡㅡ니ㅡㅡㅡㅡㅡㅡ|ㅡㅡㅡㅡㅡㅡㅡㅡㅡ야ㅡㅡㅡㅡㅡㅡ|ㅡㅡㅡㅡㅡㅡㅡㅡㅡㅡㅡㅡㅡㅡㅡ너|
개ㅡㅡ빠ㅡㅡ가ㅡㅡㅡㅡㅡㅡㅡㅡㅡ|ㅡㅡㅡㅡㅡㅡㅡㅡㅡㅡㅡㅡㅡㅡㅡㅡ|씹ㅡㅡ새ㅡㅡ끼ㅡㅡㅡㅡㅡㅡㅡㅡㅡ|ㅡㅡㅡㅡㅡㅡㅡㅡㅡㅡㅡㅡㅡㅡㅡㅡ|

ㅡ이ㅡㅡㅡ는정말아무것도안해ㅡ프|ㅡ리라이딩만하고ㅡㅡㅡㅡ이야ㅡ너|ㅡ희들은ㅡㅡ아무것도안하고ㅡㅡ맨|ㅡ날얻어먹고사는ㅡㅡㅡㅡㅡㅡㅡ너|
ㅡㅡ개새끼ㅡㅡㅡㅡㅡㅡㅡㅡㅡㅡㅡ|ㅡㅡㅡㅡㅡㅡㅡㅡ졸라지랄ㅡㅡㅡㅡ|ㅡㅡㅡㅡ씨발ㅡㅡㅡㅡㅡㅡㅡㅡㅡㅡ|ㅡㅡㅡㅡㅡㅡㅡㅡ또라ㅡ이ㅡ야ㅡㅡ|

ㅡ이ㅡㅡㅡㅡㅡ는정말ㅡㅡ안해ㅡ프|ㅡ리라이딩만하고맨날ㅡㅡㅡㅡ이야|ㅡㅡㅡㅡㅡㅡㅡㅡㅡㅡㅡㅡ오ㅡㅡ예|ㅡㅡㅡㅡㅡㅡㅡㅡㅡㅡㅡㅡㅡㅡㅡㅡ|
ㅡㅡ씨발개새끼ㅡㅡㅡ좆나ㅡㅡㅡㅡ|ㅡㅡㅡㅡㅡㅡㅡㅡㅡㅡ지랄개놈ㅡㅡ|ㅡㅡㅡㅡㅡㅡㅡㅡㅡㅡㅡㅡㅡㅡㅡㅡ|ㅡㅡㅡㅡㅡㅡㅡㅡㅡㅡㅡㅡㅡㅡㅡㅡ|

ㅡㅡㅡㅡㅡㅡㅡㅡㅡ야ㅡㅡㅡㅡㅡㅡ|어ㅡㅡ딜ㅡㅡ가ㅡㅡ니ㅡㅡㅡㅡㅡㅡ|ㅡㅡㅡㅡㅡㅡㅡㅡㅡ야ㅡㅡㅡㅡㅡㅡ|ㅡㅡㅡㅡㅡㅡㅡㅡㅡㅡㅡㅡㅡㅡㅡㅡ|
개ㅡㅡ새ㅡㅡ끼ㅡㅡㅡㅡㅡㅡㅡㅡㅡ|ㅡㅡㅡㅡㅡㅡㅡㅡㅡㅡㅡㅡㅡㅡㅡㅡ|씹ㅡㅡ새ㅡㅡ끼ㅡㅡㅡㅡㅡㅡㅡㅡㅡ|씹ㅡㅡㅡㅡㅡㅡㅡㅡㅡㅡㅡㅡㅡㅡㅡ|

ㅡㅡㅡㅡㅡㅡㅡㅡㅡ야ㅡㅡㅡㅡㅡㅡ|어ㅡㅡ딜ㅡㅡ가ㅡㅡ니ㅡㅡㅡㅡㅡㅡ|ㅡㅡㅡㅡㅡㅡㅡㅡㅡ야ㅡㅡㅡㅡㅡㅡ|ㅡㅡㅡㅡㅡㅡㅡㅡㅡㅡㅡㅡㅡㅡㅡ너|
개ㅡㅡ새ㅡㅡ끼ㅡㅡㅡㅡㅡㅡㅡㅡㅡ|ㅡㅡㅡㅡㅡㅡㅡㅡㅡㅡㅡㅡㅡㅡㅡㅡ|씹ㅡㅡ새ㅡㅡ끼ㅡㅡㅡㅡㅡㅡㅡㅡㅡ|씹ㅡㅡㅡㅡㅡㅡㅡㅡㅡㅡㅡㅡㅡㅡㅡ|

ㅡ의ㅡㅡ메스꺼운ㅡㅡㅡ눈은ㅡ그냥|ㅡㅡ버리면ㅡ너무행복할것같애ㅡ애|ㅡㅡㅡㅡㅡㅡㅡㅡㅡㅡㅡㅡㅡㅡㅡㅡ|ㅡㅡㅡㅡㅡㅡㅡㅡㅡㅡㅡㅡㅡㅡㅡ너|
ㅡㅡ좆나ㅡㅡㅡㅡ또라이ㅡㅡㅡㅡㅡ|뒤져ㅡㅡㅡㅡㅡㅡㅡㅡㅡㅡㅡㅡㅡㅡ|ㅡㅡㅡㅡㅡㅡㅡㅡㅡㅡ뻑큐이디ㅡ엿|ㅡㅡㅡㅡㅡㅡㅡㅡㅡㅡㅡㅡㅡㅡㅡㅡ|

ㅡ의ㅡㅡ가식적인ㅡㅡ새끼는ㅡ그냥|까벌리고ㅡ되는게너무좋을것ㅡ같애|ㅡㅡㅡㅡㅡㅡㅡㅡㅡㅡㅡㅡㅡㅡㅡㅡ|ㅡㅡㅡㅡㅡㅡㅡㅡㅡㅡㅡㅡㅡㅡㅡ나|
ㅡㅡ좆나ㅡㅡㅡㅡ씨발ㅡㅡㅡㅡㅡㅡ|ㅡㅡㅡㅡ좆ㅡㅡㅡㅡㅡㅡㅡㅡㅡㅡㅡ|ㅡㅡㅡㅡㅡㅡㅡㅡㅡㅡㅡㅡ뻑디스쉿|ㅡㅡㅡㅡㅡㅡㅡㅡㅡㅡㅡㅡㅡㅡㅡㅡ|

ㅡㅡㅡㅡㅡㅡㅡ가ㅡㅡㅡㅡㅡㅡㅡㅡ|ㅡㅡㅡㅡㅡㅡㅡㅡㅡㅡㅡㅡㅡㅡㅡ프|ㅡㅡㅡㅡㅡㅡㅡ리ㅡㅡㅡㅡㅡㅡㅡ라|ㅡㅡㅡㅡㅡㅡㅡ이ㅡㅡㅡ더ㅡㅡㅡㅡ|
ㅡㅡㅡㅡㅡㅡㅡㅡㅡㅡㅡㅡㅡㅡㅡ개|ㅡㅡㅡㅡㅡㅡㅡ뒤ㅡㅡㅡ져ㅡㅡㅡㅡ|ㅡㅡㅡㅡㅡㅡㅡㅡㅡㅡㅡㅡㅡㅡㅡㅡ|ㅡㅡㅡㅡㅡㅡㅡㅡㅡㅡㅡㅡㅡㅡㅡ씨|

ㅡㅡㅡㅡㅡㅡㅡㅡㅡㅡㅡㅡㅡㅡㅡㅡ|ㅡㅡㅡㅡㅡㅡㅡㅡㅡㅡㅡㅡㅡㅡㅡ프|ㅡㅡㅡㅡㅡㅡㅡ리ㅡㅡㅡㅡㅡㅡㅡ라|ㅡㅡㅡㅡㅡㅡㅡ이ㅡㅡㅡ더ㅡㅡㅡㅡ|
ㅡㅡㅡㅡㅡㅡㅡ발ㅡㅡㅡㅡㅡㅡㅡ개|ㅡㅡㅡㅡㅡㅡㅡ새ㅡㅡㅡ끼ㅡㅡㅡㅡ|ㅡㅡㅡㅡㅡㅡㅡㅡㅡㅡㅡㅡㅡㅡㅡㅡ|ㅡㅡㅡㅡㅡㅡㅡㅡㅡㅡㅡㅡㅡㅡㅡ개|

ㅡㅡㅡㅡㅡㅡㅡㅡㅡㅡㅡㅡㅡㅡㅡㅡ|ㅡㅡㅡㅡㅡㅡㅡㅡㅡㅡㅡㅡㅡㅡㅡ프|ㅡㅡㅡㅡㅡㅡㅡ리ㅡㅡㅡㅡㅡㅡㅡ라|ㅡㅡㅡㅡㅡㅡㅡ이ㅡㅡㅡ더ㅡㅡㅡㅡ|
ㅡㅡㅡㅡㅡㅡㅡ돼ㅡㅡㅡㅡㅡㅡㅡ지|ㅡㅡㅡㅡㅡㅡㅡ새ㅡㅡㅡ끼ㅡㅡㅡㅡ|ㅡㅡㅡㅡㅡㅡㅡㅡㅡㅡㅡㅡㅡㅡㅡㅡ|ㅡㅡㅡㅡㅡㅡㅡㅡㅡㅡㅡㅡㅡㅡㅡㅡ|

ㅡㅡㅡㅡㅡㅡㅡㅡㅡ야ㅡㅡㅡㅡㅡㅡ|어ㅡㅡ디ㅡㅡ가ㅡㅡ니ㅡㅡㅡㅡㅡㅡ|ㅡㅡㅡㅡㅡㅡㅡㅡ프리라이프리라이|더ㅡㅡㅡㅡㅡㅡㅡ|
개ㅡㅡ새ㅡㅡ끼ㅡㅡㅡㅡㅡㅡㅡㅡㅡ|ㅡㅡㅡㅡㅡㅡㅡㅡㅡㅡㅡㅡㅡㅡㅡㅡ|씨ㅡㅡ발ㅡㅡ놈ㅡㅡㅡㅡㅡㅡㅡㅡㅡ|ㅡㅡㅡㅡㅡㅡㅡ(뻑큐)|